1111111111111111111111111111111111111111
100000000000000C00000C000000000000000E01
1010010100100000101001000000000000000001
101001001010001000100100000C0100C0100001
1000P0000000000C00000C000000000000000001
1010010100100000101001000000010000100101
101001001010001000100100000C0100C0100101
100000000000000C00000C000000000000000001
1010010100100000101001000000010000100101
100000000000000C00000C000000000000000001
1010010100100000101001000000010000100101
100000000000000C00000C000000000000000001
100000000000000C00000C000000000000000001
100000000000000C00000C000000000000000001
1010010100100000101001000000010000100101
101001001010001000100000000C0100C0100101
100000000000000C00000C000000000000000001
1010010100100000101001000000010000100101
101001001010001000100100000C0100C0100101
1111111111111111111111111111111111111111