1111111111111111111111111111111111
100000000000000C00000C000000000E01
1010010100100000101001000000000001
101001001010001000100100000C010001
1000P0000000000C00000C000000000001
1010010100100000101001000000010101
101001001010001000100100000C010101
100000000000000C00000C000000000001
1010010100100000101001000000010101
101001001010001000100000000C010101
100000000000000C00000C000000000001
1010010100100000101001000000010101
101001001010001000100100000C010101
1111111111111111111111111111111111