11111111111111111111111111
10000000000000000000000E01
10100101001000000000000001
1010010010100010000C010001
1010010010100010000C010101
10000000000000000000000001
101P0101001000000000010101
1010010010100010000C010101
11111111111111111111111111